############################
#            ##            #
# #### ##### ## ##### #### #
# ########## ## ########## #
# #### ##### ## ##### #### #
#                          #
# #### ## ######## ## #### #
# #### ## ######## ## #### #
#      ##    ##    ##      #
###### ##### ## ##### ######
     # ##### ## ##### #
     # ##          ## #
     # ## ######## ## #
###### ## #      # ## ######
          #    	 #    
###### ## #      # ## ######
     # ## ######## ## #
     # ##          ## #
###### ## ######## ## ######
#            ##            #
# #### ##### ## ##### #### #
# #### ##### ## ##### #### #
#   ##                ##   #
### ## ## ## ## ## ## ## ###
### ## ## ## ## ## ## ## ###
#      ##          ##      #
# #### ##### ## ##### #### #
# #### ##### ## ##### #### #
#                          #
############################