############################
#...........*##*...........#
#.########################.#
#.# # # # # # # # # # #  #.#
#.########################.#
#..........................#
#.#..#.##. #....# .##.#..#.#
#.####.##.## ## ##.##.####.#
#......##....##....##......#
######.##### ## #####.######
     #.##### ## #####.#
     #.##          ##.#
     #.## ###  ### ##.#
######.## # $  % # ##.######
   ....   # $  % #   ....
######.## # $  % # ##.######
     #.## ######## ##.#
     #.##          ##.#
######.## ######## ##.######
#.....*......##......*.....#
#.####.#####.##.#####.####.#
#. ###.#####.##.#####.### .#
##  ##........@.......##  ##
###.##.##.# #### #.##.##.###
###.##.##.# #### #.##.##.###
#......##....##....##......#
#.##.#######.##.#######.##.#
#.##.#######.##.#######.##.#
#*........................*#
############################