############################
#            ##            #
# ######################## #
# # # # # # # # # # # #  # #
# ######################## #
#                          #
# #### ##  #    #  ## #### #
# #### ## ######## ## #### #
#      ##    ##    ##      #
###### ##### ## ##### ######
     # ##### ## ##### #
     # ##          ## #
     # ## ###  ### ## #
###### ## #      # ## ######
          #      #       
###### ## #      # ## ######
     # ## ######## ## #
     # ##          ## #
###### ## ######## ## ######
#            ##            #
# #### ##### ## ##### #### #
# #### ##### ## ##### #### #
######                ######
### ## ## ######## ## ## ###
### ## ## ######## ## ## ###
#      ##    ##    ##      #
# ########## ## ########## #
# ########## ## ########## #
#                          #
############################

