############################
#            ##            #
# ######################## #
# # # # # # # # # # # #  # #
# ######################## #
#                          #
# #  # ##  #    #  ## #  # #
# #### ## ## ## ## ## #### #
#      ##    ##    ##      #
###### ##### ## ##### ######
     # ##### ## ##### #
     # ##          ## #
     # ## ###  ### ## #
###### ## #      # ## ######
          #      #       
###### ## #      # ## ######
     # ## ######## ## #
     # ##          ## #
###### ## ######## ## ######
#            ##            #
# #### ##### ## ##### #### #
#  ### ##### ## ##### ###  #
##  ##                ##  ##
### ## ## # #### # ## ## ###
### ## ## # #### # ## ## ###
#      ##    ##    ##      #
# ## ####### ## ####### ## #
# ## ####### ## ####### ## #
#                          #
############################

