############################
#.....*......##......*.....#
#.####.#####.##.#####.####.#
#.#  #.#   #.##.#   #.#  #.#
#.####.#####.##.#####.####.#
#..........................#
#.####.##.#      #.##.####.#
#.####.##.########.##.####.#
#......##....##....##......#
######.##### ## #####.######
     #.##### ## #####.#
     #.##          ##.#
     #.## ###  ### ##.#
######.## #      # ##.######
      .   # $  % #   .
######.## # $  % # ##.######
     #.## ######## ##.#
     #.##          ##.#
######.## ######## ##.######
#........*...##...*........#
#.####.#####.##.#####.####.#
#.####.#####.##.#####.####.#
#...##........@.......##...#
###.##.##.##    ##.##.##.###
###.##.##.########.##.##.###
#......##....##....##......#
#.##########.##.##########.#
#.# # # # ##.##.## # # # #.#
#..........................#
############################