############################
#.....*......##......*.....#
#.####.#####.##.#####.####.#
#.####.#####.##.#####.####.#
#.####.#####.##.#####.####.#
#..........................#
#.####.##.########.##.####.#
#.####.##.########.##.####.#
#......##....##....##......#
######.##### ## #####.######
     #.##### ## #####.#
     #.##          ##.#
     #.## ###  ### ##.#
######.## #      # ##.######
      .   # $  % #   .
######.## # $  % # ##.######
     #.## ######## ##.#
     #.##          ##.#
######.## ######## ##.######
#............##............#
#.####.#####.##.#####.####.#
#.####.#####.##.#####.####.#
#...##........@.......##...#
###.##.##.########.##.##.###
###.##.##.########.##.##.###
#......##....##....##......#
#.##########.##.##########.#
#.##########.##.##########.#
#.....*..............*.....#
############################