############################
#.......*....##....*.......#
#.########################.#
#.# # # # # # # # # # #  #.#
#.########################.#
#..........................#
#.####.##. #    # .##.####.#
#.####.##.########.##.####.#
#......##....##....##......#
######.##### ## #####.######
     #.##### ## #####.#
     #.##   ....   ##.#
     #.## ###  ### ##.#
######.## # $  % # ##.######
   *...   # $  % #   ...*
######.## # $  % # ##.######
     #.## ######## ##.#
     #.## ........ ##.#
######.## ######## ##.######
#.....*......##......*.....#
#.####.#####.##.#####.####.#
#.####.#####.##.#####.####.#
######........@.......######
###.##.##.########.##.##.###
###.##.##.########.##.##.###
#......##....##....##......#
#.##########.##.##########.#
#.##########.##.##########.#
#...........*..*...........#
############################